==area:3==
@collision:B(372,127)
,,,2,1,1,1,1
,,2,1,1,1,1,1
14,14,,,,0,0,0,0,0,0,0,0,0,0
0,0,,,,14,14,14,14,14,0,0,0,0,0,0
0,0,,,,0,0,0,0,0,0,0,0,0,0,0
0,0,,,,0,0,0,0,0,0,0,0,0,0,0
0,0,0,0,0,0,0,0,0,0,0,0,0,0,0,0,0,0,0,0
@tiles1:B(371,127)
,,,,-721,722,722,722,724
,,,-721,-753,5820,5722,5722,5724
724,4,-4,-788,-754,788,0,0,0,0,0,0,0,0,0,0
788,0,0,-756,,756,4,5,5,5,5,0,0,0,0,0,0,0
756,0,0,-756,,756,0,0,0,0,0,0,0,0,0,0,0
756,0,0,-5724,5722,5724,0,0,0,0,0,0,0,0,0,0,0
756,0,0,0,0,0,0,0,0,0,0,0,0,0,0,0,0,0,0,0,0
820,722,722,722,722,722,722,722,722,722,722,722,722,722,722,722,722,722,723,723,724
@tiles2:B(371,130)
,,,,,,,,,,,,,,,,,0


,,,,,0,0,0,0,0,0,0,0,0,0
0,0,0,,0,0,0,0,0,0,0,0,0,0,0,,0,,0,0,0
@tiles3:B(371,126)
,,,,,1249,1250,1250,-1249

1315,0,0,0,0,0,0,0,,0,0,0,0,0,0



,,,,,,,,,,,,,,,,,,,0
,,,,,,,,,1249,1250,1250,-1251,-1249,1248,,1315,,,1248
@tiles5:B(371,127)
,,,,,1217,1218,1220

1220,0,0,0,0,0,0,0,0,,0,0,0,0,0,0



,,,,,,,,,,,,,,,,,,0,0
,,,,,,1217,1218,1219,1218,1219,1218,1219,1220,,1217,1218,1218,1218,1218,1220