==area:0==
@collision:B(100,113)
1,1,1,1,1,1,1,1,1,1,1,1,1,1,1,1,1,1,1,1,1,1,1,1,1,1
1,1,,,,,,,,,,,,,,,,,,,,,,,1,1
1,1,,,,,,,,,,,,,,,,,,,,,,,1,1
1,1,,,,,,,,,,,,,,,,,,,,,,,1,1
1,1,,,,,,,,,,,,,,,,,,,,,,,1,1
1,1,1,1,1,,,,,,,,,,,,,,0,0,,,,,1,1
1,1,1,1,1,,,,,,,,,,,,,,0,0,,,,,1,1
1,1,1,1,1,1,1,1,1,1,1,1,1,1,1,1,7,5,0,0,,,,,1,1
1,1,1,1,1,1,1,1,1,1,1,1,1,1,1,1,1,1,,,1,1,1,1,1,1
1,1,1,1,1,1,1,1,1,1,1,1,1,1,1,1,1,1,,,1,1,1,1,1,1
,,,,,,,,,,,,,,,,,,,,1,1,1,1,1,1
@event:L
102,95:81
102,117:80
103,95:81
103,117:80
115,114:307
115,115:307
115,116:307
115,117:307
115,118:307
115,119:307
120,114:524
120,115:524
120,116:524
120,117:524
120,118:524
120,119:524
120,120:524
121,114:526
121,115:526
121,116:526
121,117:526
121,118:526
121,119:526
121,120:526
122,114:307
122,115:307
122,116:307
122,117:307
122,118:307
122,119:307
122,120:307
@roomtype:B(5,10)
2,2
@roombg:B(5,10)
100,100
@roomcolor:B(5,10)
1,1
@tiles0:B(100,113)
,,,,,,,,129,296,296,296,296,296,-129
,,,,,,,,129,296,296,296,296,296,-129
,,,,,,,,129,296,296,296,296,296,-129
,,,,,,,,129,296,296,296,296,296,-129
,,,,,,,,129,296,296,296,296,296,-129
0,0,0,0,0,0,0,0,129,296,296,296,296,296,-129,0,0,0,0,0
0,0,0,0,0,0,0,0,129,296,296,296,296,296,-129,0,0,0,0,0
0,0,0,0,0,0,0,0,296,296,296,296,296,296,296,0,0,0,0,0
0,0,0,0,0,0,0,0,0,0,0,0,0,0,0,0,0,0,0,0
0,0,0,0,0,0,0,0,0,0,0,0,0,0,0,0,0,0,0,0
0,0,0,0,0,0,0,0,0,0,0,0,0,0,0,0,0,0,0,0
@tiles1:B(100,93)
,,1577,1578,1579
,,1609,1610,1611
,,1641,1642,1643

















137,-853,851,851,851,851,851,851,851,851,851,851,851,851,851,851,851,851,851,851,851,851,851,851,853,137,137,137,137,137,137,137,137,137,137
137,-42,,,,,,,,,,,,,,,,,,,,,,,74,137,137,137,137,137,137,137,137,137,137
137,-42,1577,1578,1579,,,,,,,,,,,,,,,,,,,,74,137,137,137,137,137,137,137,137,137,137
137,-42,1609,1610,1611,,,,,,,,,,,,,,,,,,,,74,137,137,137,137,137,137,137,137,137,137
137,-42,1641,1642,1643,,,,,,,,,,,,,,,,,,,,74,137,137,137,137,137,137,137,137,137,137
137,-106,780,780,-817,,,,,,,,,,,,,,0,0,,,,,74,137,137,137,137,137,137,137,137,137,137
137,137,137,137,-74,,,,,,,,,,,,,,0,0,,,,,74,137,137,137,137,137,137,137,137,137,137
137,137,137,137,-106,780,780,780,780,780,780,780,780,780,780,780,37,38,0,0,,,,,74,137,137,137,137,137,137,137,137,137,137
137,137,137,137,137,137,137,137,137,137,137,137,137,137,137,137,69,70,780,780,780,780,780,780,106,137,137,137,137,137,137,137,137,137,137
137,137,137,137,137,137,137,137,137,137,137,137,137,137,137,137,137,137,137,137,137,137,137,137,137,137,137,137,137,137,137,137,137,137,137
137,137,137,137,137,137,137,137,137,137,137,137,137,137,137,137,137,137,137,137,137,137,137,137,137,137,137,137,137,137,137,137,137,137,137
@tiles3:B(105,119)
1037,,,,,,1007,941,942,941,942
,,,,,,,,,,,,,941,942,661
@tiles4:B(122,114)
1780
1780
1780
1780
1780
1780
1780